W                                          W
W                                          W
W                                          W
W                                          W
W                                          W
W                                          W
W                                          W
W                                          W
W                                          W
W                                          W
W                                          W
W                                          W
W                                          W
W                                          W
W                                          W
W                                          W
W                                          W
W       LLLLLLLLLLLL         E             W
W                                          W
W     WWWWWWWWWWWW                         W
W                                          W
WWWWWWWWWWWWWWWWWWWWWWWWWWWWWWWWWWWWWWWWWWWW
