W                                          W
W                                          W
W                                          W
W                                          W
W                                          W
W                                          W
W                                          W
W                                          W
W                                          W
W                                          W
W                                          W
W                                          W
W                                          W
W                                          W
W                                          W
W                                          W
W                                          W
W       WWWWWWWWWWW                        W
W                                          W
W     WWWWWWWWWWWW                         W
W                                          W
WWWWWWWWWWWWWWWWWWWWWWWWWWWWWWWWWWWWWWWWWWWW
