W                                                                        W
W                                                                        W
W                                                                        W
W                                                                        W
W                                                                        W
W                                                                        W
W                                                                        W
W                                                                        W
W                                                                        W
W                                                                        W
W                                                                        W
W                            W                                           W
W      E            W                     W                              W
W             W           E      W                                       W
W    W   W           W    W             W                                W
W               W          W       W                                     W
W          W         W        E             W      W                AAAAAW
W       W  E      W   WWW                                           AAAAAW
W    W                 W    W    W     W      W        W            AAAAAW
W          W   W           WW              E                        AAAAAW
W       W    W        W             W    W      W    W              AAAAAW
WWWWWWWWWWWWWWWWWWWWWWWWWWWWWWWWWWWWWWWWWWWWWWWWWWWWWWWWWWWWWWWWWWWWWWWWWW
