W                                                                        W
W                                                                        W
W                                                                        W
W            E                                                           W
W    E                    E         E                                    W
W                                               E                        W
W                                                                        W
W        E       E                                                       W
W                                                       E                W
W                          E      E                                      W
W                                            E                           W
W                                                                        W
W         E                                                              W
W    E          E             E           E                              W
W                                  E             E          E            W
W                    E                                                   W
W                                                                   AAAAAW
W                          E                        E               AAAAAW
W            E                      E      E                E       AAAAAW
W       E           E                                       E       AAAAAW
W                          E                   E                    AAAAAW
WWWWWWWWWWWWWWWWWWWWWWWWWWWWWWWWWWWWWWWWWWWWWWWWWWWWWWWWWWWWWWWWWWWWWWWWWW
