W                                          W
W                                          W
W   E                                      W
W                                          W
W                                          W
W                                          W
W                                          W
W                                          W
W                                          W
W                                          W
W                                          W
W                                          W
W                                          W
W                                          W
W                                          W
W                                          W
W                                          W
W       LLLLLLLLLLLL                       W
W                                          W
W     WWWWWWWWWWWW                         W
W                                          W
WWWWWWWWWWWWWWWWWWWWWWWWWWWWWWWWWWWWWWWWWWWW
